17 16
     ###########
     #         #
  #### # ##### #
  #.        .# #
  # ### #### # #
  # #      # # #
  #    $ $   # #
### #      # # #
#   # $@   #   #
# # #      # ###
# #   $      #  
# # #      # #  
# # ### #### #  
# #.        .#  
# #### # #####  
#        #      
##########      