13 15
     #####     
    ##   ##    
  ### $ $ ###  
 ##   # #   ## 
##           ##
# $#  ... #$  #
#     .@.     #
#  $# ...  #$ #
##           ##
 ##   # #   ## 
  ### $ $ ###  
    ##   ##    
     #####     